map = [
    '############################################################',
    '#S............................#............#.....#.........#',
    '#..........#..................#......#.....#.....#.........#',
    '#..........#..................#......#.....#.....#.........#',
    '#..........#..................#......#.....#.....#.........#',
    '#..........#.........................#.....#.....#.........#',
    '#..........#..................#......#.....#...............#',
    '#..#########..................#......#.....#.....#.........#',
    '#..#..........................#......#.....#.....#.........#',
    '#..#..........................#......#.....#.....#.........#',
    '#..############################......#.....#.....#.........#',
    '#.............................#......#.....#.....#.........#',
    '#.............................#......#...........#.........#',
    '#######.##################################################.#',
    '#....#........#.................#.............#............#',
    '#....#........#........#........#.............#............#',
    '#....####.#####........#........#.............#............#',
    '#.........#............#........#.............#............#',
    '#.........#............#........#.............#............#',
    '#.........#............#........#.............#............#',
    '#.........#............#........#.............#............#',
    '#.........#............#........#.............#............#',
    '#.........#............#........####.#######.##............#',
    '#.........#............#........#....#.......#.............#',
    '#.........#............#........#....#.......#.............#',
    '#......................#........#....#.......#.............#',
    '#.........#............#........##.########..#.............#',
    '#.........#............#..................#..########.######',
    '#.........#............#..................#...............E#',
    '############################################################']